{
    "name": "Haunted Dungeon",
    "width": 40,
    "height": 20,
    "map": [
        "########################################",
        "#                           #          #",
        "# ########### #######################  #",
        "#     #                     #          #",
        "# #   #    ####### ##########          #",
        "# #   #        #                       #",
        "# #  ##   #### ###### ############     #",
        "# #          #      #            #     #",
        "# ## ######  # ######            #  #  #",
        "#     #      #                   #  #  #",
        "# #   ##### ###### ####### # #####  #  #",
        "# #                     #        #     #",
        "# ######### ########### #        #     #",
        "#                                #     #",
        "##################### ############     #",
        "#              #                       #",
        "###########  ######### ###########     #",
        "#                                #     #",
        "#                                      #",
        "########################################"
    ]
}